kenacideva	kenaci + eva
caparaṃ	ca + paraṃ
sakideva	saki + eva
āmāti	āma + iti
tyāhaṃ	te + ahaṃ
vātipi	vā + iti + api
sohaṃ	so + ahaṃ
teyeva	te + eva
nāhaṃ	na + ahaṃ
sopissa	so + api + assa
yepissa	ye + api + assa
somhi	so + amhi
atoti	ato + iti
tepi	te + api
svāyaṃ	so + ayaṃ
svāssa	so + assa
yeme	ye + ime
yepi	ye + api
sāva	sā + eva
isīti	isi + iti
midhekaccaṃ	m + idha + ekaccaṃ
soyeva	so + eva
teti	te + iti
sopi	so + api
vātiādikaṃ	vā + iti + ādikaṃ
vātiādimāha	vā + iti + ādiṃ + āha
vātiādīni	vā + iti + ādīni
vātipi	vā + iti + api
sāpi	sā + api
sāssa	sā + assa
tāyapi	tāya + api
tāyeva	tāya + eva
tāyevappāhāratāya	tāya + eva + appāhāratāya
tāyevāti	tāya + eva + iti
yantīti	yanti + iti
attanti	attaṃ + iti
kāyantīti	kāyanti + iti
yvāyanti	yo + ayaṃ + iti
yāyantipi	yā + ayaṃ + iti + api
yāyantīti	yāyanti + iti
āyantīti	āyanti + iti
ayatīti	ayati + iti
dentoti	dento + iti
ayoti	ayo + iti
kamettha	kaṃ + ettha
kaṃsi	kaṃ + asi
kamuddiseyyaṃ	kaṃ + uddiseyyaṃ
kañca	kaṃ + ca
kaññādānaṃ	kaññā + ādānaṃ
seyyathidanti	so + yathā + idaṃ + iti
tāvadeva	tāva + eva
tāvadevassa	tāva + eva + assa
tāvāhaṃ	tāva + ahaṃ
nanti	naṃ + iti
tāpi	tā + api
taṃpassa	taṃ + api + assa
maṃyeva	maṃ + eva
mañhi	maṃ + hi
maññeva	maṃ + eva
santettha	santi + ettha
santibhūtaṃ	santi + bhūtaṃ
santiupāyameva	santi + upāyaṃ + eva
yantīti	yanti + iti
udakaṭṭhānetipi	udaka + ṭhāne + iti + api
uraṭṭhiṃ	ura + aṭṭhiṃ
nevāhaṃ	na + eva + ahaṃ
yaññupāsanādinā	yaṃ + upāsana + ādinā
hāyasmantotiādimāhaṃsu	hi + āyasmanto + iti + ādiṃ + āhaṃsu
yampidaṃ	yaṃ + api + idaṃ
tiha	t + iha
disañca	disaṃ + ca
nāpi	na + api
nesā	na + esā
neso	na + eso
nesohamasmi	na + eso + ahaṃ + asmi
nete	na + ete
neva	na + eva
nevassa	na + eva + assa
nevattabyābādhāyapi	na + eva + attabyābādhāya + api
nevattantapo	na + eva + attantapo
nevattānukkaṃseti	na + eva + attānukkaṃseti
yāhaṃ	yaṃ + ahaṃ
yāhaṃ	yā + ahaṃ
yaṃkiñci	yaṃ + kiñci
yaṃnūnāhaṃ	yaṃ + nūna + ahaṃ
yaṃnūnāhamettha	yaṃ + nūna + ahaṃ + ettha
yaṃnūnāhanti	yaṃ + nūna + ahaṃ + iti
yampi	yaṃ + api
yampissa	yaṃ + api + assa
yampudāyi	yaṃ + api + udāyi
yaṃyadeva	yaṃ + yad + eva
yañca	yam + ca
yañhi	yaṃ + hi
yannūnāhanti	yaṃ + nūna + ahaṃ + iti
yāpi	yā + api
yāpissa	yā + api + assa
yeva	y + eva
yevāha	eva + āha
yevāti	eva + iti
yeveso	eva + eso
yevettha	eva + ettha
sopāsi	so + api + āsi
svāhaṃ	so + ahaṃ
svāssāti	so + assa + iti
taṃmuhuttajātarattavacchasadisacakkhubhaṇḍoti	taṃ + muhutta + jāta + ratta + vaccha + sadisa + cakkhu + bhaṇḍo + iti
tetiādimāha	te + iti + ādiṃ + āha
yāvade	yāva + eva
tasmātiha	tasmā + iha
tasmātihāti	tasmā + iha + iti
ānetīti	āneti + iti
pireti	api + are + iti
ātūti	ātu + iti
kenacidevāti	kenaci + eva + iti
imināvārahāmevāhaṃ	iminā + eva + arahāmi + eva + ahaṃ
raññikiṭāgirināmo	arañña + kiṭāgiri + nāmo
itiha	iti + ha
itveva	iti + eva
āsāti	āsā + iti
kvatthoti	ko + attho + iti
āmāhanti	āma + ahaṃ + iti
dhīti	dhī + iti
itvevāti	iti + eva + iti
aduñhi	aduṃ + hi
alañhi	alaṃ + hi
alanti	alaṃ + iti
alamettāvatā	alaṃ + ettāvatā
alamidaṃ	alaṃ + idaṃ
alametanti	alaṃ + etaṃ + iti
kutassa	kuto + assa
asiñca	asiṃ + ca
asimeva	asiṃ + eva
asimāvudhañca	asiṃ + āvudhaṃ + ca
kevalinosmaseti	kevalino + asmase + iti
asmāti	asmā + iti
seyyaṃsoti	seyyaṃ + so + iti
pāpiyaṃsoti	pāpiyaṃ + so + iti
kathaṃsūti	kathaṃsu + iti
aññadeva	añña + eva
iticiticeva	iti + ca + iti + ca + eva
sammadeva	sammā + eva
kismiñcideva	kismiñci + eva
yaññadeva	yaṃ + yad + eva
yāvadeva	yāva + eva
ahudeva	ahu + eva
kocideva	koci + eva
kiñcideva	kiñci + eva
yāvadevāti	yāva + eva + iti
sakidevāti	saki + eva + iti
sammadevāti	sammā + eva + iti
bahudevarattiṃ	bahu + eva + rattiṃ
yāvatādohipīti	yāvatā + do + hi + api + iti
yāvatādohipi	yāvatā + do + hi + api
teyevāti	te + eva + iti
āyasmānoti	āyasmā + nu + iti
nāhametamatthaṃ	na + ahaṃ + etaṃ + atthaṃ
sukhīti	sukhī + iti
natveva	na + tu + eva
imināmahaṃ	iminā + ahaṃ
imināpaṅgena	iminā + api + aṅgena
metaṃ	me + etaṃ
mettha	me + ettha
meti	me + iti
mesi	me + asi
myāyaṃ	me + ayaṃ
māhu	ma + ahu
nāhamettha	na + ahaṃ + ettha
alameva	alaṃ + eva
metthāti	me + ettha + iti
metiādimāha	me + iti + ādiṃ + āha
nāhamevaṃ	na + ahaṃ + evaṃ
noti	no + iti
yevassa	eva + assa
nevāyaṃ	na + eva + ayaṃ
sova	so + eva
nevarūpī	na + eva + rūpī
tuṇhībhūtova	tuṇhībhūto + eva
itihame	iti + ha + ime
nevidaṃ	na + eva + idaṃ
nevaṃ	na + evaṃ
nevatthi	na + eva + atthi
nevantavā	na + eva + antavā
atthāhaṃ	atthi + ahaṃ
tedha	te + idha
nayidaṃ	na + idaṃ
amāhaṃ	amuṃ + ahaṃ
yamahaṃ	yaṃ + ahaṃ
tayidaṃ	ta + idaṃ
natvevāti	na + tu + eva + iti
yamidaṃ	yaṃ + idaṃ
yamudāyi	yaṃ + udāyi
svepi	so + api
bhāvitamāsiṃsati	bhāvitaṃ + āsiṃsati
noti	no + iti
pādagaṇṭhirahu	pādagaṇṭhi + ahu
yadūpaghātāya	yad + upaghātāya
yadānulomikaṃ	yad + anulomikaṃ
micchaṃ	m + icchaṃ
tissu	iti + assu
yampicchaṃ	yaṃ + api + icchaṃ
namatthi	na + me + atthi
tāpāhaṃ	tā + api + ahaṃ
atthītissa	atthi + iti + assa
jitamhā	jita + amhā
nevasassato	na + eva + sassato
svāssudaṃ	so + assudaṃ
yañcassāhaṃ	yaṃ + ca + assa + ahaṃ
sopāgā	so + upagā
yaṃpāvuso	yaṃ + api + āvuso
vohaṃ	vo + ahaṃ
nevattānaṃ	na + eva + attānaṃ
yaṃnūna	yaṃ + nūna
vodhammā	vo + dhammā
nāmaso	nāma + so
mampi	maṃ + api
jhāyatisu	jhāyati + su
time	ti + ime
sopāga	so + upāga
svajja	so + ajja
yekeci	ye + keci
māssu	mā + ssu
yaṃnūnāhampi	yaṃ + nūna + ahaṃ + api
jalatisu	jalati + su
midhekacce	m + idha + ekacce
āmāvuso	āma + āvuso
yasassiso	yasassi + so
jalatassu	jalati + assu
jhāyatassu	jhāyati + assu
nāvuso	na + āvuso
mahañca	mahaṃ + ca
āmoti	āmo + iti
tyāssa	te + assa
tyassu	te + assu
nevasassataṃ	na + eva + sassataṃ
yeso	yo + eso
piyāmesi	piyā + me + asi
aggohamasmi	aggo + ahaṃ + asmi
dhiratthu	dhi + atthu
nopi	no + api
yañcetaṃ	yaṃ + ca + etaṃ
yañceva	yaṃ + ca + eva
itova	ito + eva
māhevaṃ	mā + hi + evaṃ
aṭṭhāhaṃ	aṭṭha + ahaṃ
nāḷakaraññikiṭāgirināmo	nāḷaka + arañña + kiṭāgiri + nāmo
vihitakaṃno	vihitakaṃ + no
tiādivacanaṃ	iti + ādi + vacanaṃ
appicchassāyaṃ	appicchassa + ayaṃ
santuṭṭhassāyaṃ	santuṭṭhassa + ayaṃ
pavivittassāyaṃ	pavivittassa + ayaṃ
āraddhavīriyassāyaṃ	āraddhavīriyassa + ayaṃ
upaṭṭhitasatissāyaṃ	upaṭṭhitasatissa + ayaṃ
samāhitassāyaṃ	samāhitassa + ayaṃ
nippapañcassāyaṃ	nippapañcassa + ayaṃ
amāhaṃ	ama + ahaṃ
amāhaṃ	amuṃ + ahaṃ
mapi	m + api
nevassu	na + eva + ssu
yidaṃ	y + idaṃ
yañhissa	yaṃ + hi + assa
nāhamasmi	na + ahaṃ + asmi
asuyeva	asu + eva
nayimaṃ	na + imaṃ
nevattabyābādhāya	na + eva + attabyābādhāya
nāpahosiṃ	na + api + ahosiṃ
mābhinandi	mā + abhinandi
yañcāhaṃ	yaṃ + ca + ahaṃ
nevattānukkaṃsessāma	na + eva + attānukkaṃsessāma
yañcāvuso	yaṃ + ca + āvuso
kosu	ko + su
nevattānukkaṃsissāma	na + eva + attānukkaṃsissāma
evaṃbyākho	evaṃ + byā + kho
yampāvuso	yaṃ + api + āvuso
tebhikkhū	te + bhikkhū
yaṃsa	yaṃ + assa
sopikho	so + api + kho
tyāvuso	te + āvuso
alañca	alam + ca
metamāsado	mā + etaṃ + āsado
māhaṃ	mā + ahaṃ
yañcassa	yaṃ + ca + assa
atthānanda	atthi + ānanda
appatissotissa	appatisso + iti + assa
midhekaccaṃ	m + idhekaccaṃ
tamenāññataro	taṃ + ena + aññataro
evaṃbyākhoti	evaṃ + byā + kho + iti
maññantīti	maññanti + iti
seyyaṃsoti	seyyaṃso + iti
pāpiyaṃsoti	pāpiyaṃso + iti
naṅgulīhi	na + aṅgulīhi
yodhapuññañca	yo + idha + puññaṃ + ca
yodhakāme	yo + idha + kāme
yodhataṇhaṃ	yo + idha + taṇhaṃ
devātipadesu	devā + iti + padesu
adhidevātipadesu	adhidevā + iti + padesu
atthetanti	atthi + etaṃ + iti
māheva	mā + hi + eva
sossa	so + assa
santetthekacce	santi + ettha + ekacce
kiñcanatasmiṃ	kiñcanatā + asmiṃ
kirame	kira + ime
atthitevassa	atthi + iti + eva + assa
khajjabhojjarasalābhiruttamaṃ	khajjabhojjarasalābhi + uttamaṃ
middhī	m + iddhī
yantitthiyo	yanti + itthiyo
yaṃpāyasmā	yaṃ + api + āyasmā
vāssa	vā + assa
yampimaṃ	yaṃ + api + imaṃ
apaṇṇakante	apaṇṇakaṃ + te
manubrūhaye	m + anubrūhaye
ādiyeva	ādi + eva
cevuttāsavā	ca + eva + uttāsavā
nevussādeyya	na + eva + ussādeyya
nevussādanā	na + eva + ussādanā
nevubhato	na + eva + ubhato
yāpetāyasmā	yāpetu + āyasmā
evammettha	evaṃ + me + ettha
tenevovādena	tena + eva + ovādena
nevidha	na + eva + idha
nayime	na + ime
cedaṃ	ce + idaṃ
yaṃnūnassāhaṃ	yaṃ + nūna + assa + ahaṃ
mānubyañjanaggāhī	mā + anubyañjanaggāhī
nevāsaṃ	na + eva + āsaṃ
sammāsaṅkappaṃpahaṃkyādīsupi	sammāsaṅkappaṃ + api + ahaṃ + kiṃ + ādīsu + api
tepīdha	te + api + idha
yidanti	idaṃ + iti
panassāti	pana + assa + iti
pabbatassāti	pabbata + assa + iti
ehayyebhiramāmaseti	ehi + ayye + abhiramāmase + iti
ramāmaseti	ramāmase + iti
puratthamatthi	puratthaṃ + atthi
tyāhutiṃ	te + āhutiṃ
tyāyaṃ	te + ayaṃ
yamariyagarahī	yaṃ + ariyagarahī
yamariye	yaṃ + ariye
yamariyaṃ	yaṃ + ariyaṃ
nahanūnimassa	na + ha + nūna + imassa
tyatthu	te + atthu
tyāssudaṃ	ta + assudaṃ
mejja	me + ajja
kome	ko + ime
mañca	maṃ + ca
nāmamhehi	nāma + amhehi
labhatippasādaṃ	labhati + pasādaṃ
labhatippasaṃsanti	labhati + pasaṃsaṃ + iti
yānukampā	yo + anukampā
sānukampā	so + anukampā
tuṇhībhūtāyamuttarā	tuṇhībhūtā + ayaṃ + uttarā
māyime	mā + ime
voti	vo + iti
gahitosīti	gahito + asi + iti
nāvattena	na + āvattena
yadāsvāhaṃ	yadā + so + ahaṃ
yannūna	yaṃ + nūna
pāpakampissa	pāpakaṃ + api + assa
mañcepi	maṃ + ce + api
tetamanuvatteti	te + taṃ + anuvatteti
yampāyasmā	yaṃ + api + āyasmā
yannūnāhampi	yaṃ + nūna + āhaṃ + api
nevasekkho	na + eva + sekkho
nāsekkho	na + asekkho
yannu	yaṃ + nu
alaṃvacanāyāti	alaṃ + vacanāyā + iti
yannūnassāhaṃ	yaṃ + nūna + assa + ahaṃ
sāhaṃ	sā + ahaṃ
nevajjhagā	na + eva + ajjhagā
itonidānā	ito + nidānā
kosudha	ko + su + idha
asatañca	asataṃ + ca
sodha	so + idha
pire	api + re
samphalanti	saṃ + phalaṃ + iti
sohamete	so + ahaṃ + ete
nayidha	na + idha
soti	so + iti
yañce	yaṃ + ce
kedha	ke + idha
svahaṃ	so + ahaṃ
nesa	na + esa
yedha	ye + idha
nocidhāpakataṃ	no + ce + idha + apakataṃ
nocidhāpagataṃ	no + ce + idha + apagataṃ
yannūnāhaṃ	yaṃ + nūna + ahaṃ
tyassa	te + assa
voccayanti	vo + accayaṃ + iti
aṭṭhīyakapiṇḍameti	aṭṭhīyakapiṇḍaṃ + eti
nocīdha	no + ca + idha
santīdha	santi + idha
vatāyanti	vata + ayaṃ + iti
thenosīti	theno + asi + iti
pādārahenavā	pādārahena + vā
atirekapādenavāti	atirekapādena + vā + iti
sasaññāyapare	sa + saññā + apare
māyidaṃ	mā + idaṃ
sūlaṃvā	sūlaṃ + vā
laguḷaṃvā	laguḷaṃ + vā
māyimaṃ	mā + imaṃ
āmayye	āma + ayye
yevānanda	ye + ānanda
pubbevassa	pubba + eva + assa
nāgānogāhanena	nāgānaṃ + ogāhanena
nattheso	na + atthi + eso
ahañcetaṃ	ahaṃ + ca + etaṃ
pupphantīti	pupphanti + iti
ubhatobyañjanāsīti	ubhatobyañjanā + asi + iti
āmāyya	āma + ayya
āmāyye	āma + ayye
nāmhākaṃ	na + amhākaṃ
dehimesaṃ	dehi + imesaṃ
māyyo	mā + ayyo
nāyyo	na + ayyo
assamamāgamissanti	assamaṃ + āgamissaṃ + iti
māyidha	mā + idha
ayyenamhi	ayyena + amhi
nāyasmā	na + āyasmā
kvāyaṃ	ko + ayaṃ
naheva	na + hi + eva
nocassa	no + ca + assa
āharayya	āhara + ayya
nayimesaṃ	na + imesaṃ
tañceti	taṃ + ce + iti
acchādetukāmosīti	acchādetukāmo + asi + iti
meyya	me + ayya
jīnosīti	jīno + asi + iti
āgatosīti	āgato + asi + iti
icchatāvuso	icchati + āvuso
handimaṃ	handa + imaṃ
kinte	kiṃ + te
māvuso	mā + āvuso
tāvade	tāva + eva
alametaṃ	alaṃ + etaṃ
yaṃpāhaṃ	yaṃ + api + ahaṃ
yampāhaṃ	yaṃ + api + ahaṃ
kvattho	ko + attho
māyye	mā + ayye
sabboyaṃ	sabbo + ayaṃ
yaṃatthāya	yaṃ + atthāya
apamārikosīti	apamāriko + asi + iti
madhumehikosīti	madhumehiko + asi + iti
accodātosīti	accodāto + asi + iti
nāccodātosīti	nāccodāto + asi + iti
mohapariyuṭṭhitosīti	mohapariyuṭṭhito + asi + iti
vītamohosīti	vītamoho + asi + iti
ajjhāpannosīti	ajjhāpanno + asi + iti
sotāpannosīti	sotāpanno + asi + iti
brāhmaṇosīti	brāhmaṇo + asi + iti
kulavaḍḍhakosīti	kulavaḍḍhako + asi + iti
saṅgharakkhitosīti	saṅgharakkhito + asi + iti
bhāradvājosīti	bhāradvājo + asi + iti
pupphachaḍḍakosīti	pupphachaḍḍako + asi + iti
gorakkhosīti	gorakkho + asi + iti
nahāpitosīti	nahāpito + asi + iti
lekhakosīti	lekhako + asi + iti
nayimesaññeva	na + imesaṃ + eva
nāyya	na + ayya
sañciccavadhasappāṇaṃ	sañcicca + vadha + sappāṇaṃ
nānānayavicittaṃ	nānā + naya + vicittaṃ
nārahatāyaṃ	na + arahati + ayaṃ
nāyye	na + ayye
tassāyaṃ	tassa + ayaṃ
cādhammenadhīyati	ca + adhammena + adhīyati
kumbhamivābhidāti	kumbhaṃ + iva + abhidā + iti
nipannāsīti	nipannā + asi + iti
cattamano	ca + attamano
chindiyeva	chindi + eva
dirattatirattañce	dirattatirattaṃ + ce
etadevaatthāya	etad + eva + atthāya
nāyyā	nu + ayyā
niccamhāti	nicca + amhā + iti
dhuvamhāti	dhuva + amhā + iti
sassatamhāti	sassata + amhā + iti
vimuttītissa	vimuttī + iti + assa
virāgotissa	virāgo + iti + assa
tissa	ti + assa
nibbidātissa	nibbidā + iti + assa
yathābhūtañāṇadassanantissa	yathābhūtañāṇadassanaṃ + iti + assa
samādhītissa	samādhi + iti + assa
sukhantissa	sukhaṃ + iti + assa
passaddhītissa	passaddhi + iti + assa
pītītissa	pīti + iti + assa
pāmojjantissa	pāmojjaṃ + iti + assa
saddhātissa	saddhā + iti + assa
dukkhantissa	dukkhaṃ + iti + assa
jātītissa	jāti + iti + assa
bhavotissa	bhavo + iti + assa
upādānantissa	upādānaṃ + iti + assa
taṇhātissa	taṇhā + iti + assa
vedanātissa	vedanā + iti + assa
phassotissa	phasso + iti + assa
saḷāyatanantissa	saḷāyatanaṃ + iti + assa
nāmarūpantissa	nāmarūpaṃ + iti + assa
viññāṇantissa	viññāṇaṃ + iti + assa
saṅkhārātissa	saṅkhārā + iti + assa
avijjātissa	avijjā + iti + assa
hāyasmā	hi + āyasmā
natumhā	na + tumhākaṃ
dissatāyaṃ	dissati + ayaṃ
ārakāvassa	ārakā + eva + assa
pucchāmahaṃ	pucchāmi + ahaṃ
yeti	ye + iti
tāvime	tāva + ime
nocedañca	no + ce + idaṃ + ca
nocedaṃ	no + ce + idaṃ
subhantveva	subhaṃ + ti + eva
kiñcarahāvuso	kiṃ + carahi + āvuso
kamuddiseyyanti	kaṃ + uddiseyyaṃ + iti
tāvadeti	tāva + eva + iti
kiṃvādāyasmantānaṃ	kiṃ + vādī + āyasmantānaṃ
sīhassevitare	sīhassa + eva + itare
nevācināti	na + eva + ācināti
nāraññe	na + araññe
mamovādena	mama + ovādena
bhabbosi	bhabbo + asi
jahantimaṃ	jahanti + imaṃ
etādisāyaṃ	etādiso + ayaṃ
saraṇattano	saraṇaṃ + attano
abhāvitattātissa	abhāvitattā + iti + assa
bhāvitattātissa	bhāvitattā + iti + assa
pañcupādānakkhandhātissa	pañcupādānakkhandhā + iti + assa
arahātissa	arahā + iti + assa
soattā	so + attā
nocamesiyā	no + ca + me + siyā
cittasseso	cittassa + eso
nīlādīhi	nīla + ādīhi
midhekacco	idha + ekacco
ahamovādena	ahaṃ + ovādena
mete	me + te
tepime	te + api + ime
māyasmantānampi	mā + āyasmantānaṃ + api
vācāvatthurevassa	vācāvatthu + eva + assa
vācāvatthudevassa	vācāvatthu + eva + assa
viharantānavassutā	viharantā + anavassutā
athoppiye	atho + appiye
cittamassūpahaññati	cittaṃ + assa + upahaññati
nibbānamuccati	nibbānaṃ + uccati
nibbānamuccatīti	nibbānaṃ uccati + iti
tasmātihāvuso	tasmā + iha + āvuso
itthetanti	ittha + etaṃ + iti
japāmaseti	japāmase + iti
anupaṭṭhitakāyassatītveva	anupaṭṭhitakāyassati + iti + eve
yāvatatthīti	yāvatā + atthi + iti
sammūḷhettha	sammūḷho + ettha
mariyebhi	m + ariyebhi
natumhākameva	na + tumhākaṃ + eva
nume	nu + ime
pariyādiyantevassa	pariyādiyantI + eva + assa
natthassa	natthi + assa
iticīticeva	iti + ca + iti + ca + eva
yathāpitveva	yathā + api + iti + eva
tathevimasmiṃ	tathā + eva + imasmiṃ
caṇḍotveva	caṇḍo + iti + eva
caṇḍoteva	caṇḍo + iti + eva
suratoteva	surato + iti + eva
tidhammo	ti + dhammo
pāhaṃ	pi + ahaṃ
yaṃbahulañca	yaṃbahulaṃ + ca
natvevāhaṃ	na + iti + eva + ahaṃ
cāvahātuṃ	ca + āvahātuṃ
bhadrarāsiyapāṭalīti	bhadra + rāsiya + pāṭalī + iti
mahāyye	mahā + ayye
dhammābhiññeyyāti	dhammā + abhiññeyyā + iti
atthattāti	atthi + attā + iti
natthattāti	natthi + attā + iti
yassapassa	yassa + api + assa
sakalamidaṃ	sakalaṃ + idaṃ
kācimā	kāci + imā
ayamācāro	ayaṃ + ācāro
sacejja	sace + ajja
maccurājāgamissatīti	maccurāja + āgamissati + iti
maccujarākampisminti	maccujara + akampismiṃ + iti
cepāyasmā	ce + api + āyasmā
sacepāyasmā	sace + api + āyasmā
appamattakāyaṃ	appamattaka + ayaṃ
sototveva	soto + iti + eva
sototi	soto + iti
yādha	yā + idha
yāssa	yā + assa
idāhaṃ	ida + ahaṃ
pabhassaramidaṃ	pabhassaraṃ + idaṃ
tepimaṃ	te + api + imaṃ
aggoti	aggo + iti
kamattha	kaṃ + attha
atthesaṃ	atthi + esaṃ
arāpi	arā + pi
sopassa	so + api + assa
saṭhoso	saṭho + so
nevādiṃ	na + eva + ādiṃ
yāvatānanda	yāvatā + ānanda
evassu	eva + assu
yopassa	yo + api + assa
sammukhāmetaṃ	sammukhā + me + etaṃ
panassāhaṃ	pana + ssu + ahaṃ
pabbatātappaṃ	pabbata + ātappaṃ
mayamassu	mayaṃ + assu
vatāyasmā	vata + āyasmā
iccāyaṃ	iti + ayaṃ
iccāyampi	iti + ayaṃ + api
iccāyante	iti + ayaṃ + te
subhanimittantissa	subhanimittaṃ + iti + assa
asubhanimittantissa	asubhanimittaṃ + iti + assa
tathāhāyaṃ	tathā + hi + ayaṃ
aṭṭhaṅgikamāhuposathaṃ	aṭṭhaṅgikaṃ + āhu + uposathaṃ
tassajja	tassa + ajja
osīdatimeva	osīdati + eva
saṃsīdatimeva	saṃsīdati + eva
sandhiyatimeva	sandhiyati + eva
saṃsandatimeva	saṃsandati + eva
sammodatimeva	sammodati + eva
adinnamicchā	adinnaṃ + icchā
pahānakkhayabbayena	pahāna + khaya + vayena
paṭighanimittantissa	paṭighanimittaṃ + iti + assa
manasikārotissa	manasikāro + iti + assa
cetovimuttītissa	cetovimutti + iti + assa
yonisomanasikārotissa	yonisomanasikāro + iti + assa
soyaṃ	so + ayaṃ
yathariva	yathā + eva
yatharivāhaṃ	yathā + eva + ahaṃ
yatharivāyaṃ	yathā + eva + ayaṃ
kathāhaṃ	kathaṃ + ahaṃ
midhekaccassa	idha + ekaccassa
temaṃ	te + imaṃ
yampāyaṃ	yaṃ + api + ayaṃ
vāyāmañca	vāyāmaṃ + ca
nāpissa	na + api + assa
yamenaṃ	yaṃ + enaṃ
attantāpo	attaṃ + tāpo
asasmīti	asa + asmi + iti
yyāssa	ye + assa
yaṃnissitā	yaṃ + nissitā
saṅkhasaddotveva	saṅkhasaddo + iti + eva
bherisaddotveva	bherisaddo + iti + eva
yampāyaṃ	yaṃ + api + ayaṃ
sukhañcetaṃdhivattatīti	sukhaṃ + ca + etaṃ + adhivattati + iti
taṇhāyogena	taṇhā + yogena
cayime	ca + ime
idamassāhaṃ	idaṃ + assa + ahaṃ
sīhassevitaremigā	sīhassa + eva + itare + migā
nājeḷakā	na + ajeḷakā
passāmissānubhāvanti	passāmi + assa + ānubhāvaṃ + iti
snehānvayamivosadhāti	snehānvayaṃ + iva + osadhā + iti
snehamanvāyamivosadhāti	snehaṃ + anvāya + iva + osadhā + iti
rohitassāpare	rohitassa + apare
atthāsaṃ	atthā + āsaṃ
kamatiṭṭhānaṃ	kamati + ṭhānaṃ
anavajjenamhi	anavajjena + amhi
karontākusalaṃ	karonta + akusalaṃ
nassevanti	na + assa + evaṃ + iti
aparāmasanti	aparāmasaṃ + iti
yenayyo	yena + ayyo
vitthārāsubhaṃ	vitthāra + asubhaṃ
vatassāyaṃ	vata + ssu + ayaṃ
vatassāyaṃ	vata + assaṃ + ayaṃ
kāmātveva	kāmā + iti + eva
āyataneti	āyatane + iti
nayimassa	na + imassa
bhikkhutveva	bhikkhu + iti + eva
aṅgantveva	aṅgaṃ + iti + eva
atthetaṃ	atthi + etaṃ
gavesināti	gavesinā + iti
brāhmaṇātveva	brāhmaṇa + iti + eva
khandhimāva	khandhimā + iva
vācatuppādā	vā + catuppādā
caṇḍālimpi	caṇḍāliṃ + api
sayanamathannapānaṃ	sayanaṃ + atha + annapānaṃ
abhiramatāyasmā	abhiramati + āyasmā
nāssassa	nāssa + assa
appaṃsupati	appaṃ + supati
sopapajjati	so + upapajjati
sopapajjatīti	so + upapajjati + iti
tyāssume	te + assu + ime
itohaṃ	ito + ahaṃ
tyassudaṃ	te + assudaṃ
khādaneti	khādane + iti
dīghācārāvāsikañca	dīgha + ācāra + āvāsikaṃ + ca
tyassume	te + assu + ime
assanti	assaṃ + iti
jarasāpi	jarasā + api
pathavītveva	pathavī + iti + eva
āpotveva	āpo + iti + eva
tejotveva	tejo + iti + eva
vāyotveva	vāyo + iti + eva
kāmarāgarattāyaṃ	kāmarāgaratta + ayaṃ
yete	ye + ete
amissīkatamevassa	amissīkataṃ + eva + assa
nayimāni	na + imāni
taṭṭhānā	ta + ṭhānā
sāpissa	sā + api + assa
tyāpare	te + āpare
vayañcassānupassatīti	vayaṃ + ca + assa + anupassati + iti
yassaṃdisaṃ	yassaṃ + disaṃ
atohayaṃ	ato + hi + ayaṃ
itopāyaṃ	ito + api + ayaṃ
yañcassā	yaṃ + ca + assā
puññamahitaṃ	puññamahi + taṃ
atthuttari	atthi + uttari
saṃvaṭṭamānassudāhaṃ	saṃvaṭṭamāna + sudaṃ + ahaṃ
sambhatamassa	sambhataṃ + assa
yācīdha	yā + ca + idha
tāti	tā + iti
pabbatāmapi	pabbataṃ + api
itāyaṃ	iti + ayaṃ
khīṇanteva	khīṇaṃ + iti + eva
dukkhamanattā	dukkhaṃ + anattā
manusāsi	m + anusāsi
niddhamathetaṃ	niddhamatha + etaṃ
ahamaṭṭhitomhīti	ahaṃ + aṭṭhito + amhi + iti
ajāyihaṃ	ajāyi + ahaṃ
nevadassanena	na + eva + dassanena
natthiyā	na + atthiyā
nonatthiyā	no + na + atthiyā
naaññamaññe	na + aññaṃ + aññe
naadhipatipaccayā	na + adhipati + paccayā
noupādā	no + upādā
vātiādi	vā + iti + ādi
nevavipākanavipākadhammadhammo	na + eva + vipāka + na + vipāka + dhamma + dhammo
nevācayagāmināpacayagāmī	na + eva + ācayagāmī + na + apacayagāmī
nevācayagāmināpacayagāmiṃ	na + eva + ācayagāmī + na + apacayagāmiṃ
nevācayagāmināpacayagāmissa	na + eva + ācayagāmī + na + apacayagāmissa
nevācayagāmināpacayagāmiñca	na + eva + ācayagāmī + na + apacayagāmiṃ + ca
nevācayagāmināpacayagāmino	na + eva + ācayagāmī + na + apacayagāmino
nevācayagāmināpacayagāminī	na + eva + ācayagāmī + na + apacayagāminī
noavigate	no + avigate
tāvettha	tāva + ettha
svassa	so + assa
nediso	na + ediso
tyajja	te + ajja
tedāni	te + dāni
yampānanda	yaṃ + api + ānanda
suddhāsuddhehi	suddhā + suddhehi
kāmaññe	kāmā + aññe
malitthiyā	malaṃ + itthiyā
aṭṭhahākārehi	aṭṭhahi + ākārehi
pātimokkhanti	pātimokkhaṃ + iti
upaṭṭhitassatissāyaṃ	upaṭṭhitassatissa + ayaṃ
nippapañcārāmassāyaṃ	nippapañcārāmassa + ayaṃ
catūhāvuso	catūhi + āvuso
sāvassā	sā + eva + assā
anatikkamanīyāti	anatikkamanīyā + iti
āyañca	āyaṃ + ca
catūhāvuso	catūhi + āvuso
tīhāvuso	tīhi + āvuso
dvīhāvuso	dvīhi + āvuso
nūname	nūna + ime
hanūname	ha + nūna + ime
paname	pana + ime
hanūname	ha + nūna + ime
navahaṅgehi	navahi + aṅgehi
vuḍḍhihesā	vuḍḍhi + hi + esā
tāvāyaṃ	tāva + ayaṃ
panassāvuso	pana + assa + āvuso
cassānupassati	ca + assa + anupassati
cassānupassatīti	ca + assa + anupassati + iti
tiādinā	iti + ādinā
jhāyīhete	jhāyī + hi + ete
tathāhimaṃ	tathā + hi + imaṃ
atthābhinibbattesuṃ	attha + abhinibbattesuṃ
parisuddhenamhi	parisuddhena + amhi
parisuddhenamhi	parisuddhena + amhi
nīvaraṇātissa	nīvaraṇā + iti + assa
asatāsampajaññantissa	asatāsampajaññaṃ + iti + assa
ayonisomanasikārotissa	ayonisomanasikāro + iti + assa
assaddhiyantissa	assaddhiyaṃ + iti + assa
asaddhammassavanantissa	asaddhammassavanaṃ + iti + assa
asappurisasaṃsevotissa	asappurisasaṃsevo + iti + assa
bojjhaṅgātissa	bojjhaṅgā + iti + assa
sattapāhaṃ	satta + api + ahaṃ
satipaṭṭhānātissa	satipaṭṭhānā + iti + assa
cattāropāhaṃ	cattāro + api + ahaṃ
indriyasaṃvarotissa	indriyasaṃvaro + iti + assa
satisampajaññantissa	satisampajaññaṃ + iti + assa
saddhammassavanantissa	saddhammassavanaṃ + iti + assa
sappurisasaṃsevotissa	sappurisasaṃsevo + iti + assa
assaddhammassavanantissa	assaddhammassavanaṃ + iti + assa
pāṭikaṅkhanti	pāṭikaṅkhaṃ + iti
pāsaṃsametaṃ	pāsaṃsaṃ + etaṃ
hirīmāyaṃ	hirīmā + ayaṃ
tintiṇapadaniddese	tintiṇa + pada + niddese
tathāhissa	tathā + hi + assa
kiṃdiṭṭhikosi	kiṃdiṭṭhiko + asi
tuvanti	tuvaṃ + iti
pacchāpetaṃ	pacchā + api + etaṃ
nameso	na + me + eso
tettha	te + ettha
hupāli	hi + upāli
nanvāyaṃ	nanu + ayaṃ
idamatthaṃtissa	idaṃ + atthaṃ + iti + assa
indriyaasaṃvarotissa	indriyaasaṃvaro + iti + assa
upāraddhasmāti	upāraddha + asmā + iti
upāraddhamhāti	upāraddha + amhā + iti
aṭṭhāneti	aṭṭhāne + iti
miccādinā	miccā + ādinā
idamatthantissa	idaṃ + atthaṃ + iti + assa
pajahateva	pajahati + eva
dhammantipadassa	dhammaṃ + iti + padassa
appakampi	appakaṃ + api
maṅgalamuttamanti	maṅgalaṃ + uttamaṃ + iti
yathindakhīlo	yathā + indakhīlo
catūhapāyehi	catūhi + apāyehi
cābhiṭhānāni	ca + abhiṭhānāni
virattacittāyatike	virattacittā + āyatike
gorakkhettha	gorakkha + ettha
caññā	ca + aññā
petānamatthāya	petānaṃ + atthāya
hitāyassa	hitāya + assa
karaṇīyamatthakusalena	karaṇīyaṃ + atthakusalena
yantasantaṃ	yaṃ + taṃ + santaṃ
nāññamaññassa	na + aññamaññassa
yāvatāssa	yāvatā + assa
vihāramidhamāhu	vihāraṃ + idha + āhu
retīti	r + eti + iti
maparājitā	m + aparājitā
petānamatthāya	petānaṃ + atthāya
tāvassunihito	tāva + ssu + nihito
cakkaṃva	cakkaṃ + iva
rukkhaṃva	rukkhaṃ + iva
uṭṭhānenappamādena	uṭṭhānena + appamādena
pabbataṭṭhova	pabbataṭṭho + iva
okamokataubbhato	okaṃ + okato + ubbhato
kāyamimaṃ	kāyaṃ + imaṃ
niratthaṃva	niratthaṃ + iva
komaṃ	ko + imaṃ
pupphamiva	pupphaṃ + iva
pupphamivappacessati	pupphaṃ + iva + pacessati
mahoghova	mahogho + iva
attanova	attano + eva
dhanammatthi	dhanaṃ + me + atthi
khīraṃva	khīraṃ + iva
bhasmacchannova	bhasmacchanno + iva
muddhamassa	muddhaṃ + assa
bhāvanamiccheyya	bhāvanaṃ + iccheyya
mamevātivasā	maṃ + eva + ativasā
nidhīnaṃva	nidhīnaṃ + iva
ovadeyyānusāseyya	ovadeyya + anusāseyya
noccāvacaṃ	na + uccāvacaṃ
puttamicche	puttaṃ + icche
nayicche	na + icche
haṃsāva	haṃsa + iva
yassāsavā	yassa + āsavā
rahadova	rahado + iva
gāthātipadassa	gāthā + iti + padassa
jeyyamattānaṃ	jeyyaṃ + attānaṃ
duvidhajjhānanibbattanasamatthaṃ	duvidha + jhāna + nibbattana + samatthaṃ
kayirāthetaṃ	kayirātha + etaṃ
māvamaññetha	mā + avamaññetha
māppamaññetha	mā + appamaññetha
jīvitukāmova	jīvitukāmo + iva
nābbaṇaṃ	na + abbaṇaṃ
visamanveti	visaṃ + anveti
māvoca	mā + avoca
kasāmiva	kasā + iva
parijiṇṇamidaṃ	parijiṇṇaṃ + idaṃ
yānimānipaviddhāni	yāna + imāni + apaviddhāni
alābūneva	alābūni + eva
alāpūneva	alāpūni + eva
balibaddhova	balibaddho + iva
balivaddova	balivaddo + iva
jiṇṇakoñcāva	jiṇṇakoñcā + iva
khīṇamaccheva	khīṇamacche + iva
cāpātikhīṇāva	cāpātikhīṇā + iva
yathāññamanusāsati	yathā + aññamanusāsati
vasmamayaṃ	v + asmamayaṃ
vajiraṃvamhamayaṃ	vajiraṃ + iva + amhamayaṃ
sālamivotthataṃ	sālaṃ + iva + otthataṃ
nāññamañño	na + aññamañño
nāññamañño	nāññaṃ + añño
attadatthamabhiññāya	attadatthaṃ + abhiññāya
jitamassa	jitaṃ + assa
ñātīnaṃva	ñātīnaṃ + iva
nakkhattapathaṃva	nakkhattapathaṃ + iva
yuñjamattānaṃ	yuñjaṃ + attānaṃ
sotthimāgataṃ	sotthiṃ + āgataṃ
katapuññampi	katapuññaṃ + api
bhantaṃva	bhantaṃ + iva
dajjāppasmimpi	dajjā + appasmim + api
ajjatanāmiva	ajjatanāṃ + iva
mitabhāṇimpi	mitabhāṇiṃ + api
paṇḍupalāsova	paṇḍupalāso + iva
yamapurisāpi	yamapurisā + api
pātheyyampi	pātheyyaṃ + api
idhevameso	idha + eva + eso
kaliṃva	kaliṃ + iva
buddhānamiñjitaṃ	buddhānaṃ + iñjitaṃ
tulaṃva	tulaṃ + iva
varamādāya	varaṃ + ādāya
maggānaṭṭhaṅgiko	maggānaṃ + aṭṭhaṅgiko
maggamisippaveditaṃ	maggaṃ + isippaveditaṃ
khīrapakova	khīrapako + iva
sāradikaṃva	sāradikaṃ + iva
santimaggameva	santimaggaṃ + eva
yānimānipaviddhāni	yāni + imāni + apaviddhāni
himavantova	himavanto + iva
asantettha	asanto + ettha
damayamattānaṃ	damayaṃ + attānaṃ
raṭṭhapiṇḍamasaññato	raṭṭhapiṇḍaṃ + asaññato
nirayāyupakaḍḍhati	nirayāya + upakaḍḍhati
rājābhirūhati	rājā + abhirūhati
ājānīyāva	ājānīyā + eva
kuñjarāva	kuñjarā + eva
mahāvarāhova	mahāvarāho + iva
uddharathattānaṃ	uddharatha + attānaṃ
sannova	sanno + iva
sattova	satto + iva
phalamicchaṃva	phalaṃ + icchaṃ + iva
abhivaṭṭhaṃva	abhivaṭṭhaṃ + iva
abhivaḍḍhaṃva	abhivaḍḍhaṃ + iva
abhivaṭṭaṃva	abhivaṭṭaṃ + iva
yāvantettha	yāvanto + ettha
naḷaṃva	naḷaṃ + iva
sasova	saso + iva
rāgarattānupatanti	rāgarattā + anupatanti
makkaṭakova	makkaṭako + iva
dukkhamidanti	dukkha + idaṃ + iti
tatrāyamādi	tatra + ayaṃ + ādi
codayattānaṃ	codaya + attānaṃ
saṃyamamattānaṃ	saṃyamaṃ + attānaṃ
saṃyamayattānaṃ	saṃyamaya + attānaṃ
bhadraṃva	bhadraṃ + iva
virajamāsīnaṃ	virajaṃ + āsīnaṃ
katakiccamanāsavaṃ	katakiccaṃ + anāsavaṃ
brāhmaṇassetadakiñci	brāhmaṇassa + etad + akiñci
aggihuttaṃva	aggihuttaṃ + iva
pokkharapatteva	pokkharapatte + iva
saccamudīraye	saccaṃ + udīraye
saṅgamupaccagā	saṅgaṃ + upaccagā
satevīsacatussatā	sa + tevīsa + catusatā
attalokaṃ	atta + lokaṃ
dhammaṭṭhamaggañca	dhammaṭṭha + maggaṃ + ca
gāthāyuddānaṃ	gāthāya + uddānaṃ
jarattekādasa	jarā + atta + ekādasa
pupphabālasahassamhi	puppha + bāla + sahassamhi
pāpasukhamhi	pāpa + sukhamhi
satevīsa	sa + tevīsa
yamakappamādo	yamaka + appamādo
gāthānamuddānaṃ	gāthānaṃ + uddānaṃ
jīvakapañhavatthu	jīvaka + pañha + vatthu
belaṭṭhasīsattheravatthu	belaṭṭhasīsa + thera + vatthu
anuruddhattheravatthu	anuruddha + thera + vatthu
mahākaccāyanattheravatthu	mahākaccāyana + thera + vatthu
anatthapucchakabrāhmaṇavatthu	anattha + pucchaka + brāhmaṇa + vatthu
sahāyakabrāhmaṇavatthu	sahāyaka + brāhmaṇa + vatthu
petānamatthāya	petānaṃ + atthāya
abalassaṃva	abalassaṃ + iva
ñātīva	ñātī + iva
ayasāva	ayasā + iva
sūriyova	sūriyo + iva
suriyova	suriyo + iva
yassussadā	yassa + ussadā
disvānassā	disvāna + assā
ummujjanimujjampi	ummujjanimujjaṃ + api
thūpañcassa	thūpaṃ + ca + assa
attanāvedi	attanā + avedi
khuddaputtāmhi	khuddaputtā + amhi
yañcidaṃ	yaṃ + ca + idaṃ
phassāti	phassā + iti
paramanti	paramaṃ + iti
yassantarato	yassa + antarato
bhavissantipissa	bhavissaṃ + iti + api + assa
vanavasesā	vā + anavasesā
taṇhakkhayasukhassete	taṇhakkhayasukhassa + ete
muñcāmahaṃ	muñcāmi + ahaṃ
tete	te + ete
pabbatova	pabbato + iva
nibbānamattanoti	nibbānaṃ + attano + iti
yassāyaṃ	yassa + ayaṃ
vippamokkhamāhaṃsu	vippamokkhaṃ + āhaṃsu
nissaraṇamāhaṃsu	nissaraṇaṃ + āhaṃsu
asesamete	asesaṃ + ete
yakkhampi	yakkhaṃ + api
yassevaṃ	yassa + evaṃ
jīvitampi	jīvitaṃ + api
nayimehi	na + imehi
upeccapi	upecca + api
uppatitvāpi	uppatitvā + api
palāyatanti	palāyataṃ + iti
kilantosīti	kilanto + asi + iti
kilantomhīti	kilanto + amhā + iti
kalyāṇiyāsi	kalyāṇiyā + asi
cāsi	ca + asi
visamānīva	visamāni + iva
kilantomhīti	kilanto + amhi + iti
siddhamidanti	siddhaṃ + idaṃ + iti
vidūti	vidū + iti
tamogadhanti	taṃ + ogadhaṃ + iti
saṅgamaticca	saṅgaṃ + aticca
metīti	m + eti + iti
etete	ete + te
pajjotamivādhipātakā	pajjotaṃ + iva + adhipātakā
obhāsitameva	obhāsitaṃ + eva
anārammaṇamevetaṃ	anārammaṇaṃ + eva + etaṃ
iccheyyāhaṃ	iccheyyaṃ + ahaṃ
navapi	nava + api
paṭiccappabhavanti	paṭicca + pabhavanti
āyujaṭilavekkhaṇā	āyu + jaṭila + paccavekkhaṇā
macchāva	macchā + iva
vaggamidaṃ	vaggaṃ + idaṃ
vaggamidaṭṭhakaṃ	vaggaṃ + ida + aṭṭhakaṃ
udānamitīdamāhu	udānaṃ + iti + idaṃ + āhu
atthāyetaṃ	atthāya + etaṃ
udānamitimāhu	udānaṃ + iti + āhu
udānantidamāhu	udānaṃ + iti + idaṃ + āhu
atthamāgamāti	atthamāgamā + iti
vaggamāhu	vaggaṃ + āhu
tadaṅgādippahānavasena	tad + aṅga + ādi + pahāna + vasena
makkhāgato	makkha + āgato
puññameva	puññaṃ + eva
amaccharāti	amaccharā + iti
manasānukampaṃ	manasā + anukampaṃ
yajamānānupariyagā	yajamānā + anupariyagā
sattimānidha	satta + imāni + idha
suguttānidha	suguttāni + idha
yañcaññaṃ	yaṃ + ca + aññaṃ
katvānākusalaṃ	katvāna + akusalaṃ
akatvākusalaṃ	akatvā + akusalaṃ
akatvākusalaṃ	akatvā + kusalaṃ
suṇāthetaṃ	suṇātha + etaṃ
esanāti	esanā + iti
akathaṃkathīti	akathaṃkathī + iti
savāhananti	savāhanaṃ + iti
muttamanti	m + uttamaṃ + iti
addhāti	addhā + iti
ekasaṃyojanampi	ekasaṃyojanaṃ + api
bhāvitattaññataraṃ	bhāvitatta + aññataraṃ
puttamicchanti	puttaṃ + icchanti
ekasaṃyojanampi	ekasaṃyojanaṃ + api
kusāpi	kusā + api
pattāpi	pattā + api
sāsaneti	sāsane + iti
santimevādhigacchatīti	santiṃ + eva + adhigacchati + iti
vuṭṭhīva	vuṭṭhi + iva
tālapakkaṃva	tālapakkaṃ + iva
ādiccovudayaṃ	ādicco + iva + udayaṃ
bhindantāyaṃ	bhindanto + ayaṃ
udabindūva	udabindu + iva
yepassa	ye + api + assa
dassanampahaṃ	dassanaṃ + api + ahaṃ
savanampahaṃ	savanaṃ + api + ahaṃ
upasaṅkamanampahaṃ	upasaṅkamanaṃ + api + ahaṃ
payirupāsanampahaṃ	payirupāsanaṃ + api + ahaṃ
anussaraṇampahaṃ	anussaraṇaṃ + api + ahaṃ
anupabbajjampahaṃ	anupabbajjaṃ + api + ahaṃ
anussatimpahaṃ	anussatiṃ + api + ahaṃ
raṇañjahātipi	raṇañjaha + iti + api
catukkañca	catukkaṃ + ca
ekakamhi	ekako + amhi
yadeko	yadā + eko
sappavisaṃva	sappavisaṃ + iva
jiṇṇamivattacaṃ	jiṇṇaṃ + iva + tacaṃ
jiṇṇamiva	jiṇṇaṃ + iva
bhisapupphaṃva	bhisapupphaṃ + iva
naḷasetuṃva	naḷasetuṃ + iva
vitathamidanti	vitathaṃ + idaṃ + iti
yassānusayā	yassa + anusayā
vuṭṭhimpi	vuṭṭhiṃ + api
saheyyumāgataṃ	saheyyuṃ + āgataṃ
baddhāsi	baddhā + asi
aṭṭhamahāsaṃvegavatthusamāvajjanañca	aṭṭha + mahā + saṃvega + vatthu + samāvajjanaṃ + ca
tāhaṃ	te + ahaṃ
imāvuso	ime + āvuso
sahottappañāṇaṃ	saha + ottappa + ñāṇaṃ
abhisāpāyaṃ	abhisāpo + ayaṃ
abhisapāyaṃ	abhisapo + ayaṃ
chavālātaṃva	chavālātaṃ + iva
tvevidaṃ	tu + eva + idaṃ
mahiyekarattivāso	mahiyā + ekarattivāso
punupeyya	aññataraṃ + api
puttamiccheyya	puttaṃ + iccheyya
sandiṭṭhikasamparāyikasokaparidevādinānappakārakaṃ	sandiṭṭhika + samparāyika + sokaparidevā + ādi + nānappakārakaṃ
visālova	visālo + iva
pabbajitāpi	pabbajitā + api
tiṃsapalaguḷapiṇḍappamāṇāva	tiṃsa + pala + guḷapiṇḍa + pamāṇā + eva
sabbānipetāni	sabbāni + api + etāni
parittamettha	parittaṃ + ettha
dukkhamettha	dukkhaṃ + ettha
patthayamappamatto	patthayaṃ + appamatto
padumaṃva	padumaṃ + iva
cundāti	cunda + iti
tādisāti	tādisā + iti
iṇamatthīti	iṇaṃ + atthi + iti
kiñcikkhamādeti	kiñcikkhaṃ + ādeti
jaññāti	jaññā + iti
cattānaṃ	ca + attānaṃ
mavajānāti	m + avajānāti
yathāpedaṃ	yathā + api + idaṃ
pañcamatthi	pañcamo + atthi
sūdha	su + idha
padamaccutaṃ	padaṃ + accutaṃ
aniketamasanthavaṃ	aniketaṃ + asanthavaṃ
jāyantamassa	jāyantaṃ + assa
sinehamassa	sinehaṃ + assa
munimappamattaṃ	muniṃ + appamattaṃ
sīhaṃva	sīhaṃ + iva
vātaṃva	vātaṃ + iva
padmaṃva	padmaṃ + iva
tasaraṃva	tasaraṃ + iva
tāvamhi	tāva + amhi
pañcakkhandhadvādasāyatanadvattiṃsākārasaccapaṭiccasamuppādādivasena	pañcakkhandha + dvādasa + āyatana + dvattiṃsākāra + sacca + paṭiccasamuppāda + ādi + vasena
sālīnamannaṃ	sālīnaṃ + annaṃ
esāmagandho	esa + āmagandho
paresamādāya	paresaṃ + ādāya
macchamaṃsānamanāsakattaṃ	macchamaṃsānaṃ + anāsakattaṃ
satamasnamānā	sataṃ + asnamānā
nāggihuttassupasevanā	na + aggihuttassupasevanā
randhamevānupassī	randhaṃ + eva + anupassī
akkhātampi	akkhātaṃ + api
puññappabhāvānuggahitasarīrā	puñña + pabhāva + anuggahita + sarīrā
brāhmaṇānamadā	brāhmaṇānaṃ + adā
aṭṭhānavutimāgamuṃ	aṭṭhānavutiṃ + āgamuṃ
evameso	evaṃ + eso
bhariyāvamaññatha	bhariyā + avamaññatha
indaṃva	indaṃ + iva
brāhmaṇānāsuṃ	brāhmaṇānaṃ + āsuṃ
tebhirattā	te + abhirattā
veko	vā + eko
heta	hi + eta
isimavocuṃ	isiṃ + avocuṃ
kvajja	kva + ajja
aññāsamatimaññihanti	aññāsaṃ + atimaññi + ahaṃ + iti
paṇṇacchadanasālāpi	paṇṇa + chadana + sālā + api
sappasseva	sappassa + iva
matante	mataṃ + te
cīvaracetāpananti	cīvaracetāpanaṃ + iti
cātumāsapaccayapavāraṇā	cātumāsa + paccayapavāraṇā
uttariñcassa	uttariṃ + ca + assa
buddhādiāmisapūjā	buddha + ādi + āmisa + pūjā
suciraparinibbutopi	suciraparinibbuto + api
pacchimājanatānukampamānasā	pacchimājanatā + anukampamānasā
duggatapaṇṇākārabhūte	duggata + paṇṇākāra + bhūte
ratanattayapaṇāmagāthāyo	ratanattaya + paṇāma + gāthāyo
saṃvegaparikittanapāṭhañca	saṃvega + parikittana + pāṭhaṃ + ca
yoccantasuddhabbarañāṇalocano	yo + accanta + suddha + bara + ñāṇa + locano
pāpūpakilesaghātako	pāpa + upakilesa + ghātako
sabbupaddavā	sabba + upaddavā
janatānukampa	janatā + anukampa
yoccanta	yo + accanta
suddhabbara	suddha + bara
pākāmata	pāka + amata
sukhettābhyati	sukhetta + abhyati
maggapākāmatabhedabhinnako	magga + pāka + amata + bheda + bhinnako
dhammapahaṃsāna	dhamma + pahaṃsāna
dhammapahaṃsānapāṭhaṃ	dhamma + pahaṃsāna + pāṭhaṃ
dvattiṃsākārapaccavekkhaṇa	dvattiṃsa + ākāra + paccavekkhaṇa
dvattiṃsākārapāṭhaṃ	dvattiṃsa + ākāra + pāṭhaṃ
sabbītiyo	sabba + ītiyo
kāladānasuttagāthā	kāladānasutta + gāthā
santikaro	santi + karo
saddhammasenā	saddhamma + senā
pāpūpakilesajetā	pāpa + upakilesa + jetā
santiniyojako	santi + niyojako
namokārānubhāvena	namo + kāra + ānubhāvena
paṭirūpadesavāso	paṭirūpa + desa + vāso
yambuddhaseṭṭho	yaṃ + buddhaseṭṭho
viriyampītipassaddhi	viriyaṃ + pīti + passaddhi
yandunnimittaṃ	yaṃ + dunnimittaṃ
devatāgatā	devatā + gatā
mārātirekamabhiyujjhitasabbarattiṃ	māra + atirekaṃ + abhiyujjhita + sabba + rattiṃ
ghorampanāḷavakamakkhamathaddhayakkhaṃ	ghoraṃ + pana + āḷavakaṃ + akkhama + thaddha + yakkhaṃ
dāvaggicakkamasanīva	dāvaggi + cakkaṃ + asanī + iva
ukkhittakhaggamatihatthasudāruṇantaṃ	ukkhitta + khaggaṃ + atihattha + sudāruṇaṃ + taṃ
dhāvantiyojanapathaṅgulimālavantaṃ	dhāvaṃ + tiyojana + patha + aṅguli + mālavantaṃ
vādābhiropitamanaṃ	vāda + abhiropita + manaṃ
atiandhabhūtaṃ	atiandha + bhūtaṃ
nandopanandabhujagaṃ	nandopananda + bhujagaṃ
iddhūpadesavidhinā	iddhi + upadesa + vidhinā
dinadine	dina + dine
nandivaḍḍhano	nandi + vaḍḍhano
asaṅkiliṭṭhāsaṅkilesikā	asaṅkiliṭṭha + asaṅkilesikā
nevācayagāmino	neva + ācaya + gāmino
nāpacayagāmino	na + apacaya + gāmino
adāsime	adāsi + me
vaññā	vā + aññā
uddissanādhiṭṭhānagāthāyo	uddissana + adhiṭṭhāna + gāthāyo
uddissanādhiṭṭhānā	uddissana + adhiṭṭhānā
vomataṃ	vo + amataṃ
nokāsaṃ	na + okāsaṃ
tesottamānubhāvena	tesaṃ + uttama + ānubhāvena
sattānantāppamāṇakā	satta + ananta + appamāṇakā
cāpyadiṭṭhā	ca + api + adiṭṭhā
catuyonikā	catu + yonikā
pattidānamme	patti + dānaṃ + me
tisaraṇagamanaṃ	ti + saraṇa + gamanaṃ
tisaraṇa	ti + saraṇa
saddhāpakatamesānaṃ	saddhāpakataṃ + esānaṃ
usūyakañca	usūyakaṃ + ca
daḷhamāruhitvā	daḷhaṃ + āruhitvā
nevācare	na + eva + ācare
kāyagatātyatthu	kāyagatā + te + atthu
tamovassa	tamo + eva + assa
paramasuddhippattapañño	parama + suddhi + patta + pañño
pahānamāsavānaṃ	pahānaṃ + āsavānaṃ
anagārameti	anagāraṃ + eti
ñāṇamavecca	ñāṇaṃ + avecca
sotukāmamhāti	sotukāma + amhā + iti
rājadūtābhidhāvantu	rājadūtā + abhidhāvantu
pahitattampi	pahitattaṃ + api
jīvamanupucchasi	jīvaṃ + anupucchasi
mevaṃ	me + evaṃ
pagāḷhettha	pagāḷha + ettha
medavaṇṇaṃva	medavaṇṇaṃ + iva
nomhi	no + amhi
tassijjheti	tassa + ijjhe + iti
hutamijjhe	hutaṃ + ijjhe
vedagumaddasāma	vedaguṃ + addasāma
tassijjheti	tassa + ijjhe + iti
caññāsi	ca + aññāsi
hutamatthu	hutaṃ + atthu
yaññamāgataṃ	yaññaṃ + āgataṃ
vattayamappamatto	vattayaṃ + appamatto
byagghusabhova	byagghusabho + iva
vīsāyapi	vīsāya + api
tiṃsāyapi	tiṃsāya + api
cattālīsāyapi	cattālīsāya + api
paññāsāyapi	paññāsāya + api
etthappatiṭṭhāya	ettha + patiṭṭhāya
bhāvayamappamāṇaṃ	bhāvayaṃ + appamāṇaṃ
satatamappamatto	satataṃ + appamatto
kenattanā	kena + attanā
careyyāsīti	careyyāsi + iti
daharopi	daharo + api
pattinamāhu	pattinaṃ + āhu
dantamāhu	dantaṃ + āhu
vigatarajamanaṅgaṇaṃ	vigatarajaṃ + anaṅgaṇaṃ
saṃsāramaticca	saṃsāraṃ + aticca
mānusakañca	mānusakaṃ + ca
navamahaggatakusalacetanābhedañca	nava + mahaggata + kusalacetanā + bhedaṃ + ca
jālamaticca	jālaṃ + aticca
vīriyavāti	vīriyavā + iti
yānidhatthi	yāni + idha + atthi
vedamaticca	vedaṃ + aticca
caraṇavāti	caraṇavā + iti
mānamathopi	mānaṃ + atho + api
paribbājakamāhu	paribbājakaṃ + āhu
attanāttānaṃ	attano + attānaṃ
puññakhettamanuttaraṃ	puññakhettaṃ + anuttaraṃ
tesamantakaromi	tesaṃ + antakaromi
okāsakammamattampi	okāsakammamattaṃ + api
okāsamattampi	okāsamattaṃ + api
kaṅkhitamaññāsi	kaṅkhitaṃ + aññāsi
adhivāsetveva	adhivāsetu + eva
animittamanaññātaṃ	animittaṃ + anaññātaṃ
jarampi	jaraṃ + api
phalānamiva	phalānaṃ + iva
evamabbhāhato	evaṃ + abbhāhato
hiṃsamattānaṃ	hiṃsaṃ + attānaṃ
hiṃsamattānamattanā	hiṃsaṃ + attānaṃ + attanā
sokamappajahaṃ	sokaṃ + appajahaṃ
phandantevidha	phandanti + eva + idha
saraṇamādittaṃ	saraṇaṃ + ādittaṃ
tūlaṃva	tūlaṃ + iva
pajappañca	pajappaṃ + ca
puṭṭhumāgamhā	puṭṭhuṃ + āgamhā
nāṅgulīhi	na + aṅgulīhi
dīgharattamanusayitaṃ	dīgharattaṃ + anusayitaṃ
tenevābādhena	tena + eva + ābādhena
bhojanamatthi	bhojanaṃ + atthi
timisamāyanti	timisaṃ + āyanti
nibbānapadābhipatthayāno	nibbānapada + abhipatthayāno
bhiyyassuppajjate	bhiyyo + assa + uppajjate
padakasma	padakā + asma
rajamākirasī	rajaṃ + ākirasī
samuppilavāte	samuppilavā + te
tīramapatthi	tīraṃ + api + atthi
cakkamisivhaye	cakkaṃ + isi + avhaye
nadaṃva	nadaṃ + iva
turitamavasarī	turitaṃ + avasarī
jalitamiva	jalitaṃ + iva
ukkāmukheva	ukkāmukhe + iva
sikhimiva	sikhiṃ + iva
saradarivabbhamuttaṃ	sarada + iva + abbhamuttaṃ
vipulamalattha	vipulaṃ + alattha
athattano	atha + attano
gamanamanussaranto	gamanaṃ + anussaranto
ahitamanussarāmi	ahitaṃ + anussarāmi
cāpimassa	ca + api + imassa
phusissatāyaṃ	phusissati + ayaṃ
vattessatāyaṃ	vattessati + ayaṃ
giramabbhudīrayi	giraṃ + abbhudīrayi
ciramidhāvaseso	ciraṃ + idha + avaseso
dhammamaggaṃ	dhammaṃ + aggaṃ
aññātametaṃ	aññātaṃ + etaṃ
vanantamabhihāraye	vanantaṃ + abhihāraye
attānamabhitosayaṃ	attānaṃ + abhitosayaṃ
gāmantamabhihāraye	gāmantaṃ + abhihāraye
gāmamāgamma	gāmaṃ + āgamma
rukkhaṃvupanivattati	rukkhaṃ + eva + upanivattati
rukkhaṃva	rukkhaṃ + eva
monamakkhātaṃ	monaṃ + akkhātaṃ
pūrova	pūro + iva
dvayatānupassanāti	dvayatānupassanā + iti
siyātissu	siyā + iti + assu
upadhipaccayāti	upadhipaccayā + iti
avijjāyeva	avijjāya + eva
phassapaccayāti	phassapaccayā + iti
taṇhāpaccayāti	taṇhāpaccayā + iti
upādānapaccayāti	upādānapaccayā + iti
ārambhapaccayāti	ārambhapaccayā + iti
āhārapaccayāti	āhārapaccayā + iti
iñjitapaccayāti	iñjitapaccayā + iti
santatarāti	santatarā + iti
diṭṭhamariyehi	diṭṭhaṃ + ariyehi
sampamūḷhetthaviddasu	sampamūḷha + ettha + aviddasu
upādānārambhaāhārā	upādāna + ārambha + āhārā
soḷasāti	soḷasā + iti
monamajjhagāti	monamajjhagā + iti
sallaviddhova	sallaviddho + iva
maddantenaṃ	maddanti + enaṃ
bhinnamivodakaṃ	bhinnaṃ + iva + odakaṃ
bahunābhichanno	bahunā + abhichanno
purimeva	purime + eva
visamanti	visamaṃ + iti
appañhidaṃ	appaṃ + hi + idaṃ
maccheva	macche + iva
āsattimakubbamāno	āsattiṃ + akubbamāno
caramappamatto	caraṃ + appamatto
duṭṭhamanāpi	duṭṭhamanā + api
kathamaccayeyya	kathaṃ + accayeyya
anānupuṭṭhova	anānupuṭṭho + eva
tamariyadhammaṃ	taṃ + ariyadhammaṃ
yadattani	yad + attani
māyañca	māyaṃ + ca
diṭṭhimidheva	diṭṭhiṃ + idha + eva
evābhijānaṃ	evaṃ + abhijānaṃ
etābhijānaṃ	etaṃ + abhijānaṃ
suddhimāha	suddhiṃ + āha
hīnāti	hīnā + iti
sabbamāha	sabbaṃ + āha
yadattanī	yad + attanī
hīnamaññaṃ	hīnaṃ + aññaṃ
diṭṭhimpi	diṭṭhiṃ + api
samoti	samo + iti
attānamanūpaneyya	attānaṃ + anūpaneyya
ñāṇepi	ñāṇe + api
diṭṭhimapi	diṭṭhiṃ + api
yassūbhayante	yassa + ubhayante
paṇidhīdha	paṇidhi + idha
aṇūpi	aṇu + api
diṭṭhimanādiyānaṃ	diṭṭhiṃ + anādiyānaṃ
vassasatāpi	vassasatā + api
jarasāpi	jarasā + api
vinābhāvasantamevidaṃ	vinābhāva + santaṃ + eva + idaṃ
mamidanti	mama + idaṃ + iti
mamayidanti	mama + idaṃ + iti
diṭṭhāpi	diṭṭhā + api
sutāpi	sutā + api
nāmamidaṃ	nāmaṃ + idaṃ
nāmamevāvasissati	nāmaṃ + eva + avasissati
vivittamāsanaṃ	vivittaṃ + āsanaṃ
sāmaggiyamāhu	sāmaggiyaṃ + āhu
visuddhimicchati	visuddhiṃ + icchati
methunamanuyuttassa	methunaṃ + anuyuttassa
metteyyāti	metteyya + iti
hīnamāhu	hīnaṃ + āhu
etadariyānamuttamaṃ	etad + ariyānaṃ + uttamaṃ
visuddhimāhu	visuddhiṃ + āhu
pasaṃsamicchaṃ	pasaṃsaṃ + icchaṃ
parihīnamāhu	parihīnaṃ + āhu
abhigajjameti	abhigajjaṃ + eti
paṭisūramicchaṃ	paṭisūraṃ + icchaṃ
diṭṭhimuggayha	diṭṭhiṃ + uggayha
sampayātaveti	sampayātave + iti
pavitakkamāgamā	pavitakkaṃ + āgamā
bhavūpapattiñca	bhavūpapattiṃ + ca
sīlavatānujīvitaṃ	sīlavataṃ + anujīvitaṃ
māgaṇḍiyāti	māgaṇḍiya + iti
māgandiyāti	māgandiya + iti
passañca	passaṃ + ca
momuhameva	momuhaṃ + eva
aṇumpi	aṇuṃ + api
canūpalittaṃ	ca + anūpalittaṃ
piyānu	piyā + nu
dvayameva	dvayaṃ + eva
mamattamatthi	mamattaṃ + atthi
upanissitāti	upanissitā + iti
paṭikkosamakevalī	paṭikkosaṃ + akevalī
sakaṃsakaṃdiṭṭhiparibbasānā	sakaṃsakaṃ + diṭṭhiparibbasānā
dhammamanānujānaṃ	dhammaṃ + anānujānaṃ
sabbevime	sabbe + eva + ime
sakaṃsakaṃdiṭṭhimakaṃsu	sakaṃsakaṃ + diṭṭhiṃ + akaṃsu
kapīva	kapi + iva
ettāvataggampi	ettāvatā + aggaṃ + api
takkamanussaranti	takkaṃ + anussaranti
dvayadhammamāhu	dvayadhammaṃ + āhu
sayamattanā	sayaṃ + attanā
yābhivadanti	yā + abhivadanti
suddhimakevalī	suddhiṃ + akevalī
suddhimakevalīno	suddhiṃ + akevalīno
tyābhirattā	te + abhirattā
medhagamāvaheyya	medhagaṃ + āvaheyya
nindamanvānayanti	nindaṃ + anvānayanti
pasaṃsampi	pasaṃsaṃ + api
kimeyya	kiṃ + eyya
khantimakubbamāno	khantiṃ + akubbamāno
saññamenāhu	saññamena + āhu
satthāva	satthā + iva
santimanuggahāya	santiṃ + anuggahāya
suddhimanutthunanti	suddhiṃ + anutthunanti
panāhu	pana + āhu
paripuṇṇamāhu	paripuṇṇaṃ + āhu
sammutimāhu	sammutiṃ + āhu
paraneyyamatthi	paraneyyaṃ + atthi
dhammamaññaṃ	dhammaṃ + aññaṃ
tathaddasā	tatha + addasā
abhabbuppattikāni	abhabba + uppattikāni
munīdha	muni + idha
dhammamabhijaññā	dhammaṃ + abhijaññā
ajjhattamevupasame	ajjhattaṃ + eva + upasame
santimeseyya	santiṃ + eseyya
annānamatho	annānaṃ + atho
athāsanesu	atha + āsanesu
nāññamatimaññe	nāññaṃ + atimaññe
santīti	santi + iti
sakkhidhammamanītihamadassī	sakkhidhammaṃ + anītihaṃ + adassī
bhayamāvisi	bhayaṃ + āvisi
bhavanamattano	bhavanaṃ + attano
osānetveva	osāne + iti + eva
sallamaddakkhiṃ	sallaṃ + addakkhiṃ
sallamabbuyha	sallaṃ + abbuyha
sikkhānukiriyanti	sikkhā + anugīyanti
tamānisaṃsaṃ	taṃ + ānisaṃsaṃ
nirassatīti	nirassati + iti
dutīyamatthi	dutīyaṃ + atthi
atisāradiṭṭhiyāva	atisāradiṭṭhiyā + eva
bālamasuddhidhammaṃ	bālaṃ + asuddhidhammaṃ
sāvajjanavajjametaṃ	sāvajjanavajjaṃ + etaṃ
saddhammapūjāpi	saddhammapūjā + api
samantamasāro	samantaṃ + asāro
sikkhānugīyanti	sikkhā + anugīyanti
gaṇimāgato	gaṇiṃ + āgato
ratimajjhagā	ratiṃ + ajjhagā
gaṇimāgataṃ	gaṇiṃ + āgataṃ
rittamāsanaṃ	rittaṃ + āsanaṃ
kyāssassu	kiṃ + assa + assu
sīlabbatānāssu	sīlabbatāni + assu
paradhammikānampi	paradhammikānaṃ + api
yadāvilattaṃ	yad + āvilattaṃ
athappiyaṃ	atha + piyaṃ
kudha	ko + idha
soyevattho	so + eva + attho
satimābhinande	satiṃ + abhinande
mahāyaññamakappayi	mahāyaññaṃ + akappayi
vacanamabravi	vacanaṃ + abravi
ñāṇamettha	ñāṇaṃ + ettha
manasāyeva	manasā + eva
tasitovudakaṃ	tasito + iva + udakaṃ
mahālābhaṃva	mahālābhaṃ + iva
pabbatamāruhuṃ	pabbataṃ + āruhuṃ
sataraṃsīva	sataraṃsī + iva
nāmanighaṇḍurukkhādīnaṃ	nāma + nighaṇḍu + rukkha + ādīnaṃ
kametaṃ	kaṃ + etaṃ
vanasavhayaṃ	vanasa + avhayaṃ
kissābhilepanaṃ	kiṃ + assa + abhilepanaṃ
jappābhilepanaṃ	jappā + abhilepanaṃ
paññāyete	paññāya + ete
katthetaṃ	kattha + etaṃ
manasānāvilo	manasā + anāvilo
ubhantamabhiññāya	ubhantaṃ + abhiññāya
sibbinimaccagā	sibbiniṃ + accagā
puṇṇakāti	puṇṇaka + iti
kāmābhijappanti	kāma + abhijappanti
mettagūti	mettagū + iti
etābhinandāmi	etaṃ + abhinandāmi
nūnappajaheyyu	nūna + pajaheyyu
saṅgamimaṃ	saṅgaṃ + imaṃ
tenahātappaṃ	tena + hi + ātappaṃ
dhotakāti	dhotaka + iti
brāhmaṇamiriyamānaṃ	brāhmaṇaṃ + iriyamānaṃ
ākāsova	ākāso + iva
upasīvāti	upasīva + iti
pūgampi	pūgaṃ + api
pamāṇamatthi	pamāṇaṃ + atthi
vādapathāpi	vādapathā + api
sabbeti	sabbe + iti
nandāti	nanda + iti
nivutāti	nivutā + iti
anekarūpampi	anekarūpaṃ + api
oghatiṇṇāti	oghatiṇṇā + iti
dhammamakkhāhi	dhammaṃ + akkhāhi
nibbānapadamaccutaṃ	nibbānapadaṃ + accutaṃ
todeyyāti	todeyya + iti
dīpamakkhāhi	dīpaṃ + akkhāhi
paddhagūti	paddhagū + iti
vīramakāmakāmiṃ	vīraṃ + akāmakāmiṃ
āsavāssa	āsavā + assa
bhadrāvudhāti	bhadrāvudha + iti
udayāti	udaya + iti
sakkānupucchāmi	sakka + anupucchāmi
posālāti	posāla + iti
tiṭṭhantamenaṃ	tiṭṭhantaṃ + enaṃ
piṅgiyāti	piṅgiya + iti
kiñcanamatthi	kiñcanaṃ + atthi
jatukaṇṇīti	jatukaṇṇi + iti
vanasavhayaṃ	vanasa + avhayaṃ
nattamahābhipassa	nattamahaṃ + abhipassa
pārāyanamanugāyissaṃ	pārāyanaṃ + anugāyissaṃ
yathāddakkhi	yathā + addakkhi
tathākkhāsi	tathā + akkhāsi
pahīnamalamohassa	pahīna + mala + mohassa
mānamakkhappahāyino	māna + makkha + pahāyino
sabbabhavātivatto	sabbabhavaṃ + ativatto
kānanamāvaseyya	kānanaṃ + āvaseyya
taṇhakkhayamanītikaṃ	taṇhakkhayaṃ + anītikaṃ
cakkhunāva	cakkhunā + iva
pañhānantakaro	pañhānaṃ + antakaro
paṭhamakaṭṭhavaro	paṭhamaka + aṭṭha + varo
hirimaṅgalanāmo	hiri + maṅgala + nāmo
kāmaguhaṭṭhakaduṭṭhakanāmā	kāma + guhaṭṭhaka + duṭṭhaka + nāmā
mettiyavaro	mettiya + varo
dhammamadāsi	dhammaṃ + adāsi
parakhemajaniyaṃ	para + khema + janiyaṃ
suttavaraṃ	sutta + varaṃ
byañjanamatthapadaṃ	byañjanaṃ + atthapadaṃ
rāgavirāgamanejamasokaṃ	rāgavirāgaṃ + anejaṃ + asokaṃ
taṇhāratacchadanatāṇalatāpamokkhaṃ	taṇhārata + chadana + tāṇa + latā + pamokkhaṃ
taṇhātalaratacchedanatāṇapamokkhaṃ	taṇhā + tala + rata + chedana + tāṇa + pamokkhaṃ
aṇṇavamūpamaratanasucittaṃ	aṇṇavaṃ + upama + ratana + sucittaṃ
ravimūpamatejaṃ	raviṃ + upama + tejaṃ
maccutatāṇaparaṃ	m + accuta + tāṇa + paraṃ
evampahaṃ	evaṃ + api + ahaṃ
kiṃpattinamāhu	kiṃ + pattinaṃ + āhu
nāpentime	nāpenti + ime
sataraṃsiṃva	sataraṃsiṃ + iva
uddhaṃsa	uddhaṃ + sa
sayaṃva	sayaṃ + eva
viriyavāso	viriyavā + so
haññadatthatthi	hi + añña + attha + atthi
kuppapaṭiccasantiṃ	kuppapaṭicca + santiṃ
mupāgamuṃ	m + upāgamuṁ
diṭṭhimakaṃsu	diṭṭhiṃ + akaṃsu
manusāsati	m + anusāsati
viriyavāti	viriyavā + iti
tamanudāsino	tamanudo + āsino
mānamakkhappahāyino	māna + makkha + pahāyino
sammāparibbājanīyopi	sammāparibbājanīyo + api
puṭṭhumakāmamāgamaṃ	puṭṭhuṃ + akāmaṃ + āgamaṃ
pārāyananteva	pārāyanaṃ + iti + eva
dasamāsaccayena	dasamāsa + accayena
ādīnavavibhāvanatthameva	ādīnava + vibhāvana + atthaṃ + eva
idamajaramidamamaraṃ	idaṃ + ajaraṃ + idaṃ + amaraṃ
aviraddhoyevāsīti	aviraddho + eva + asi + iti
tatopaññena	tato + api + aññena
suññatānimittasamāpattiyova	suññatā + animitta + samāpattiyo + eva
palāpettha	palāpo + ettha
vānurakkhituṃ	vā + anurakkhituṃ
cetehi	ca + etehi
conatā	ca + onatā
manti	maṃ + iti
padānupubbatāpetaṃ	pada + anupubbatā + api + etaṃ
hupeyyapāvusoti	hupeyya + api + āvuso + iti
sīhānaṃva	sīhānaṃ + iva
imamatthamabhāsisuṃ	imaṃ + atthaṃ + abhāsisuṃ
dumapattaṃva	dumapattaṃ + iva
dhitimāti	dhitimā + iti
nirāmiseti	nirāmise + iti
subbatāti	subbatā + iti
nigacchasīti	nigacchasi + iti
ariyamaṭṭhaṅgikamañjasaṃ	ariyaṃ + aṭṭhaṅgikaṃ + añjasaṃ
sāmaññamakiñcanassāti	sāmaññaṃ + akiñcanassa + iti
vedhīti	vedhī + iti
tuyhāpadāne	tuyhaṃ + apadāne
katāti	katā + iti
sīlameva	sīlaṃ + eva
dullabhanti	dullabhaṃ + iti
gatamāyusaṅkhayaṃ	gataṃ + āyusaṅkhayaṃ
bālampi	bālaṃ + api
sīhappamatto	sīha + appamatto
bhagavānusāsati	bhagavā + anusāsati
pāṇitaleva	pāṇitale + eva
mahogheva	mahogho + eva
visaṃhatāti	visaṃhatā + iti
mayajja	mayā + ajja
sesakenamhi	sesakena + amhi
parinibbissatyanāsavoti	parinibbissati + anāsavo + iti
santhavanti	santhavaṃ + iti
tūlamiva	tūlaṃ + iva
pilavatīva	pilavati + iva
tvevānatthasaṃhitaṃ	tu + eva + anatthasaṃhitaṃ
tathāhayaṃ	tathā + hi + ayaṃ
vaneti	vane + iti
kalyatanti	kalyataṃ + iti
mahāmunīti	mahāmuni + iti
satatamaniccatanti	satataṃ + aniccataṃ + iti
samaṇasādhutāti	samaṇasādhutā + iti
papañca	papaṃ + ca
abhisattova	abhisatto + iva
aññamiva	aññaṃ + iva
vanasavhayo	vana + savhayo
ekakeva	ekake + eva
mahesibhīti	mahesibhi + iti
bhavenamhi	bhavena + amhi
niggahītosi	niggahīto + asi
chavasittova	chavasitto + eva
dhammamassosiṃ	dhammaṃ + assosiṃ
kaṅkhamabhijānāmi	kaṅkhaṃ + abhijānāmi
mahiddhikāti	mahiddhikā + iti
satimāti	satimā + iti
pakubbatīti	pakubbati + iti
janamevassito	janaṃ + eva + assito
pahāyānappake	pahāya + anappake
ratinti	ratiṃ + iti
kappasatānāhaṃ	kappasatāni + ahaṃ
maggamakkhāhi	maggaṃ + akkhāhi
gaṅgāsotova	gaṅgāsoto + iva
ādāsamādāya	ādāsaṃ + ādāya
ñāṇadassanamattano	ñāṇadassanaṃ + attano
orasanti	orasaṃ + iti
anāsavanti	anāsavaṃ + iti
carimoyaṃ	carimo + ayaṃ
kassindriyāni	kassa + indriyāni
mayhindriyāni	mayhaṃ + indriyāni
cattavaṇṇaṃ	ca + attavaṇṇaṃ
uttamamaccutaṃ	uttamaṃ + accutaṃ
nandamānāgataṃ	nandamānaṃ + āgataṃ
sūlamāropamānakaṃ	sūlaṃ + āropamānakaṃ
mānatthe	mā + anatthe
saññamalabhiṃ	saññaṃ + alabhiṃ
pañcāhāhaṃ	pañcāhaṃ + ahaṃ
manutappati	m + anutappati
bhāvayeti	bhāvaye + iti
